NO 			./sprites/north.xpm

WE 				./sprites/west.xpmu



C 225,30,0				

EA ./sprites/east.xpm
SO ./sprites/south.xpm

F 1,1,1    
wawawa
ztzzz


	111111
1S0001
100001
100001
111111


y