NO ./sprites/north.xpm

WE 				./sprites/west.xpm

F 1,1,100


C 1,30,2 

EA ./sprites/east.xpm

        
SO ./sprites/south.xpm






1111111
 1S0001
100010111
1011
11111
100001
111111
