NO ./sprites/north.xpm

WE 				./sprites/west.xpm



C 1,30,2 

EA ./sprites/east.xpm

        
SO ./sprites/south.xpm





111111
 1S0001
100010111
1111
11
100001
111111     

F 1,1,100