NO ./sprites/north.xpm

WE ./sprites/west.xpm

F 1,1,100 


C 1,30,20 			

EA 					./sprites/east.xpm

        

SO ./sprites/south.xpm

1 1
111 111
11111 
1101W111 1                   
11110001
11111

