NO ./sprites/north.xpm

WE 				./sprites/west.xpm



C 1,30,29			

EA ./sprites/east.xpm

        
SO ./sprites/south.xpm




F 1,1,100

111110
 1S0001
100010111
1111
11
100001
111111     
