NO ./sprites/north.xpm

WE 				./sprites/west.xpm

F 1,1,100


C 1,30,2 

EA ./sprites/east.xpm

        
SO ./sprites/south.xpm




1     1
11111111111
11011110001
10001011111
1011 111     
1111111
1000001
11111111
