NO ./sprites/north.xpm

WE ./sprites/west.xpm

F 1,1,100 


C 1,30,20 			

EA 					./sprites/east.xpm

        

SO ./sprites/south.xpm

1 1  1
111 101
11111111
1101W101 1                   
11110001
1111111

