NO ./sprites/north.xpm
SO ./sprites/south.xpm
WE ./sprites/west.xpm
EA ./sprites/east.xpm

C 148,192,252
F 76,129,55

1 1  1
111 111
11111111
1101W101 1                   
11110001
1111111
