NO ./sprites/north.xpm

WE ./sprites/west.xpm

F 1,1,100 


C 1,30,2 

EA ./sprites/east.xpm

        
SO ./sprites/south.xpm




1 1
111 11
1101  1
1111
1 1
1
