NObbbbbb 			./sprites/north.xpm

WE 				./sprites/west.xpmu



C 225,30,0				

EA ./sprites/east.xpm
SO ./sprites/south.xpm

F 1,1,1    
        

1111111
 	1S0001
100010111
1111
11
100001
111111     




