NO ./sprites/north.xpm
SO ./sprites/south.xpm
WE ./sprites/west.xpm
EA ./sprites/east.xpm

C 148,192,252
F 76,129,55

1111
1N01
1111