NO ./sprites/minecraft_north.xpm
SO ./sprites/minecraft_south.xpm
WE ./sprites/minecraft_west.xpm
EA ./sprites/minecraft_east.xpm

C 135,206,235
F 194,131,64

1111
1N01
1111