NO ./sprites/north.xpm

WE ./sprites/west.xpm

F 1,1,100 


C 1,30,20 			

EA 					./sprites/east.xpm

        

SO ./sprites/south.xpm

111111111111111111111111111111111111
100000000000000W00000000000000000001
100110000000000000000000000000000001111111
100000000000000000000000000000000000000001
100000000000000000000000000000000001111111
100000000000000000000000000000000001
100000000001111111100000000000000001
100000000001000000100000000000000001
100000000001000000100000000000000001
100000000001111111100000000000000001
100000000000000000000000000000000001
100000000000000000000000000000000001
100000000000000000000000000000000001
100000000000000000000000000000000001
100000000000000000000000000000000001
100000000000000000000000000000000001
111111111111111111111111111111111111
