NO	./sprites/north.xpm     
EA	./sprites/east.xpm
SO	./sprites/south.xpm
WE	./sprites/west.xpm
D	./sprites/door.xpm

C 225,255,255			
F 1,1,1

111111111
100000101
101000101
100100WD1
100000001
100100001
101000001
100000001
111111111
